acosar|sujetar|retener|sostener|asir|atar|pegar|adherir|someter|amoldar|
ofender|denigrar|alabar|violar|
aparcar|posponer|retrasar|atrasar|diferir|apartar|aplazar|tardar|
ventilar|oxigenar|indagar|
descontar|regatear|deducir|abonar|sortear|
abrazar|rodear|acordonar|circundar|
comprender|contener|incluir|alcanzar|cubrir|ocupar|abarcar|obtener|adquirir|entender|reportar|
curvar|combar|arquear|flexionar|
guarnecer|proveer|suministrar|surtir|abastecer|suplir|repartir|distribuir|
batir|percutir|golpear|sacudir|ganar|batallar|contender|chocar|vibrar|calentar|clavar|
deprimir|adormecer|
acabar|hundir|coronar|agotar|cumplir|caducar|
recargar|mezclar|incrementar|combinar|diluir|barajar|
pasmar|aturdir|confundir|liar|precipitar|
anular|revocar|cancelar|casar|disolver|abolir|cesar|
odiar|detestar|condenar|despreciar|
regar|saciar|
sintetizar|resumir|abreviar|acortar|
rasgar|desplegar|inaugurar|aclarar|brindar|abrir|informar|clarear|felicitar|convidar|
empezar|comenzar|iniciar|principiar|emprender|incoar|
gritar|silbar|chiflar|
descargar|eximir|perdonar|remitir|rehabilitar|liberar|librar|depositar|enviar|facturar|expedir|absolver|
asimilar|aprovechar|digerir|
denegar|molar|
inducir|generalizar|idealizar|
atropellar|aplastar|
enmendar|corregir|retocar|mejorar|completar|
terminar|finalizar|concluir|liquidar|cerrar|
excitar|inflamar|encender|alterar|
acampar|alojar|
rayar|volar|cruzar|
amasar|acumular|
herir|lastimar|lacerar|fracturar|dislocar|torcer|maltratar|perjudicar|
activar|manejar|manipular|gesticular|mover|estimular|acelerar|maniobrar|operar|guiñar|
engrasar|untar|ungir|
purificar|depurar|perfeccionar|filtrar|dimitir|
llamar|nombrar|designar|tachar|chillar|clamar|titular|borrar|
calificar|describir|delinear|dibujar|
atribuir|asignar|aplicar|culpar|acusar|
guardar|conservar|meter|velar|ahorrar|inyectar|
arreglar|adornar|embellecer|bordar|
blanquear|
anotar|interpretar|comentar|escribir|
recurrir|acudir|apelar|interponer|
recomendar|sugerir|guiar|avisar|advertir|proponer|invitar|inspirar|encaminar|entrenar|
convenir|estipular|pactar|negociar|concertar|comerciar|conciliar|
añorar|extrañar|
aumentar|crecer|
recordar|recuperar|
reflejar|revelar|mostrar|demostrar|manifestar|exponer|exhibir|constatar|expresar|enunciar|
lograr|conseguir|avanzar|
desconfiar|recelar|sospechar|conjeturar|presumir|suponer|inferir|intuir|predecir|presentir|prever|vislumbrar|entrever|entrañar|colegir|derivar|temer|
guisar|cocinar|
consentir|aprobar|tolerar|permitir|mimar|
predicar|convertir|anunciar|
grabar|tornear|modelar|fotocopiar|imprimir|
afiliar|asociar|incorporar|inscribir|apuntar|ingresar|congregar|sentar|subrayar|
obligar|atañer|vincular|
asegurar|amarrar|
paralizar|oxidar|
tramitar|gestionar|
asfixiar|sofocar|angustiar|neutralizar|
morir|fallecer|expirar|sucumbir|
arruinar|destruir|devastar|
compilar|codificar|recopilar|reunir|clasificar|coleccionar|relacionar|
cribar|tamizar|colar|escoger|
subyugar|dominar|aprisionar|reprimir|frenar|predominar|
convencer|persuadir|
enojar|irritar|indignar|descomponer|exasperar|
divulgar|difundir|pregonar|propagar|publicar|notificar|
gastar|deteriorar|
llegar|durar|demorar|ascender|
entretener|distraer|divertir|cautivar|
instruir|educar|
transferir|donar|
peinar|cardar|
facilitar|simplificar|favorecer|solucionar|
camelar|embaucar|enredar|mentir|
referir|mencionar|citar|convocar|
botar|saltar|brincar|
anhelar|ansiar|desear|aspirar|apetecer|pretender|intentar|
obstruir|bloquear|presionar|influir|
atenuar|debilitar|
reforzar|alentar|
estancar|detener|
preparar|disponer|prevenir|legislar|alertar|
parecer|representar|simbolizar|figurar|recitar|
encerrar|recluir|aislar|retirar|desconectar|
entusiasmar|interesar|gustar|
granizar|llover|
infectar|contagiar|
allanar|nivelar|
arrebatar|arrancar|
autorizar|legalizar|certificar|validar|legitimar|formalizar|contestar|
rascar|hurgar|roer|
ordenar|organizar|
contratar|emplear|
tostar|asar|
empeñar|comprometer|garantizar|
ahogar|estrangular|
rociar|salpicar|irrigar|
tensar|estirar|
retumbar|tronar|
contravenir|infringir|
drenar|evaporar|
burbujear|escupir|
murmurar|chismear|charlar|cuchichear|
balbucear|susurrar|
insistir|machacar|
flotar|nadar|emerger|
emascular|castrar|
enfrentar|confrontar|
sanar|curar|restablecer|aliviar|
hablar|conversar|departir|platicar|
tintar|pintar|
bombear|sacar|extraer|
limitar|restringir|condicionar|recortar|prohibir|impedir|
situar|establecer|localizar|ubicar|estacionar|
rebatir|impugnar|contradecir|
engullir|ingerir|tomar|
tramar|planear|
fabricar|elaborar|producir|
venerar|adorar|
dar|dedicar|ofrecer|rendir|
madurar|meditar|decidir|cavilar|reflexionar|pensar|
narrar|relatar|
responder|replicar|reponer|
dividir|partir|
decapitar|degollar|segar|
quebrar|interrumpir|
recolectar|recoger|
ejercer|desempeñar|ejercitar|practicar|
alumbrar|parir|
evacuar|exonerar|orinar|
reclamar|pedir|exigir|protestar|requerir|
ilustrar|clarificar|
llorar|lamentar|sentir|
vencer|derrotar|
originar|crear|imaginar|trazar|idear|inventar|concebir|
elegir|nominar|
escurrir|resbalar|patinar|
olvidar|ocultar|
ralentizar|parar|
usar|utilizar|
verificar|realizar|
limpiar|suprimir|alejar|
nacer|salir|
encajar|insertar|
radiar|irradiar|
lubricar|lubrificar|suavizar|
vender|traicionar|
amoblar|amueblar|decorar|
explotar|reventar|
vivir|existir|
salvar|excluir|
jurar|blasfemar|maldecir|insultar|
expatriar|emigrar|
padecer|sufrir|
seducir|embelesar|encantar|conquistar|polarizar|cegar|invadir|
sollozar|hipar|
licenciar|investir|graduar|
roncar|bramar|refunfuñar|
crujir|chascar|
regir|gobernar|mandar|
probar|saborear|degustar|
unificar|equiparar|
vacunar|inocular|
rogar|suplicar|
protagonizar|significar|
levar|elevar|alzar|
fundir|fusionar|
mendigar|postular|
lloriquear|gimotear|
prolongar|perseverar|permanecer|persistir|proseguir|
contar|numerar|decir|
enterrar|tapar|esconder|
recetar|formular|prescribir|
articular|orquestar|
helar|congelar|
cobrar|recibir|
amenazar|retar|
refinar|complicar|
incinerar|achicharrar|arder|
exceder|sobrar|repercutir|
rechazar|repeler|rehusar|
enfriar|refrigerar|
agitar|revolver|reaccionar|
menstruar|doler|
gratificar|agradar|
alquilar|arrendar|
frecuentar|convivir|compartir|
comprar|corromper|
valuar|tasar|
latir|pulsar|palpitar|
fortificar|blindar|
bailar|danzar|tejer|
barrer|escobar|cepillar|
deponer|derrocar|privar|
devolver|reintegrar|restituir|
doblar|duplicar|
exfoliar|caer|
ladrar|aullar|
modernizar|actualizar|renovar|restaurar|
nevar|neviscar|
personalizar|individualizar|
pescar|capturar|atrapar|cazar|agarrar|coger|pillar|
renacer|resucitar|
bañar|zozobrar|
almorzar|comer|masticar|nutrir|merendar|
expeler|despedir|eliminar|emitir|expulsar|
lanzar|tirar|proyectar|disparar|derramar|emanar|extender|empujar|impeler|verter|soltar|
conmemorar|festejar|descartar|ejecutar|exhalar|editar|planificar|calcular|urdir|filmar|
rodar|diseminar|desembocar|dispersar|ampliar|encoger|impulsar|volcar|
abandonar|confiar|entregar|abrigar|regalar|conceder|otorgar|proporcionar|conferir|legar|
equivocar|errar|fallar|tropezar|
separar|deshacer|licuar|
invertir|cambiar|volver|modificar|virar|voltear|mudar|
transcurrir|correr|pasar|viajar|
adoptar|señalar|
reparar|rehacer|reformar|apercibir|zurcir|
aprender|formar|cultivar|memorizar|estudiar|
hartar|inflar|hinchar|
andar|caminar|marchar|circular|pasear|vagar|recorrer|ir|trasladar|patear|
lucir|sobresalir|destacar|culminar|prevalecer|
debatir|combatir|luchar|pelear|resistir|
intoxicar|colgar|
morar|habitar|
naufragar|fracasar|frustrar|
vestir|llevar|portar|adaptar|acomodar|
basar|descansar|apoyar|fundar|posar|sosegar|cansar|planchar|instituir|
bendecir|glorificar|
temblar|asustar|espantar|
respirar|inhalar|
litigar|pleitear|denunciar|cuestionar|
navegar|embarcar|
arrastrar|remolcar|deslizar|
broncear|curtir|habituar|
visitar|saludar|presentar|inspeccionar|examinar|cumplimentar|supervisar|
contaminar|dificultar|
desnudar|desvestir|
conectar|orientar|introducir|plantar|aportar|colocar|calzar|comunicar|
bajar|depreciar|menguar|disminuir|reducir|
igualar|empatar|emparejar|
balizar|marcar|abalizar|indicar|contrastar|firmar|afectar|
matricular|dirigir|liderar|defender|proteger|acoger|conducir|presidir|
administrar|controlar|aconsejar|canalizar|destinar|cobijar|
desistir|renunciar|dejar|ceder|zarpar|regresar|actuar|
fiar|esperar|encargar|encomendar|creer|aguardar|solicitar|acechar|
gandulear|vegetar|tumbar|
juntar|cohabitar|adjuntar|soldar|añadir|agregar|yuxtaponer|despegar|
llenar|saturar|rellenar|embutir|cargar|
humillar|entristecer|desolar|afligir|
derribar|derrumbar|inclinar|desanimar|derruir|demoler|abatir|
plantear|alegar|declarar|aventurar|
pagar|satisfacer|remunerar|lucrar|enriquecer|acreditar|avalar|recompensar|
soportar|aguantar|admitir|afrontar|conformar|tragar|devorar|
estropear|fastidiar|joder|dañar|
invalidar|mutilar|fornicar|follar|
instigar|provocar|apresurar|besar|alborotar|
agredir|coquetear|causar|promover|suscitar|motivar|
albergar|tener|mantener|poseer|beneficiar|juzgar|custodiar|cuidar|
pulir|bruñir|aliñar|
embeber|chupar|empapar|absorber|adelgazar|infiltrar|mojar|humedecer|procurar|
sangrar|exprimir|abusar|
ocurrir|suceder|venir|desarrollar|reemplazar|sustituir|
continuar|heredar|
construir|confeccionar|efectuar|acostumbrar|
lamer|tocar|acariciar|arañar|besuquear|palpar|sonar|corresponder|pertenecer|
depender|necesitar|reconocer|servir|subordinar|pender|obedecer|acatar|mirar|traer|
acceder|suspender|cerner|
atisbar|espiar|vigilar|observar|fijar|divisar|captar|
cortar|amputar|cuajar|
fortalecer|templar|coagular|caldear|moderar|
adivinar|resolver|descubrir|encontrar|hallar|pronosticar|insinuar|colonizar|traducir|
leer|converger|contrariar|disentir|
residir|quedar|constituir|erigir|implantar|radicar|acordar|
alegrar|iluminar|enseñar|
definir|concretar|precisar|explicar|detallar|especificar|determinar|
enumerar|diferenciar|
levantar|desobedecer|
apacentar|alimentar|rumiar|
copular|montar|costar|
alargar|tender|acercar|
enloquecer|alienar|
reclutar|enganchar|
prender|acoplar|
escalar|subir|esquilar|asaltar|
comprobar|repasar|
estremecer|alarmar|emocionar|
descender|desaconsejar|provenir|
vacilar|dudar|
huir|escapar|
bostezar|suspirar|espirar|despertar|
hervir|romper|irrumpir|
garrapatear|colorear|
censurar|criticar|pinchar|satirizar|ridiculizar|disciplinar|sacrificar|atormentar|
evolucionar|transformar|progresar|
entrar|comparecer|triunfar|valer|impresionar|conmover|
robar|quitar|soplar|mermar|
anticipar|financiar|colaborar|plegar|
arrojar|echar|arremeter|embestir|atacar|
regular|ajustar|medir|adecuar|coincidir|concordar|
surgir|aparecer|brotar|asomar|florecer|
enchufar|enlazar|unir|concentrar|sindicar|
acompañar|agrupar|
estrechar|perseguir|buscar|ojear|seguir|
preceder|superar|
contemplar|disfrutar|gozar|revisar|ensayar|experimentar|entrevistar|
asumir|aceptar|contraer|incriminar|
apaciguar|calmar|mitigar|anestesiar|
trabajar|laborar|esforzar|transportar|asesinar|ahorcar|matar|
envenenar|linchar|incomodar|
simular|fingir|disimular|reproducir|engañar|disfrazar|ilusionar|imitar|copiar|
porfiar|discutir|
enfocar|abordar|tratar|deliberar|consultar|
agravar|hospitalizar|
ligar|aliar|
empeorar|apretar|
taladrar|calar|punzar|perforar|
evitar|eludir|
encarcelar|arrestar|
extinguir|exterminar|
